Crawlid => Crawler
Vengefly => Buzzer
Vengefly King => BigBuzzer
Gruzzer => Bouncer
Gruz Mother => BigFly
Tiktik => Climber
Aspid Hunter => Spitter
Aspid Mother => Hatcher
Aspid Hatchling => Hatchling
Goam => Worm
Wandering Husk => ZombieRunner
Husk Hornhead => ZombieHornhead
Leaping Husk => ZombieLeaper
Husk Bully => ZombieBarger
Husk Warrior => ZombieShield
Husk Guard => ZombieGuard
Entombed Husk => Mummy
False Knight => FalseKnight
Maggot => PrayerSlug
Menderbug => MenderBug
Lifeseed => HealthScuttler
Baldur => Roller
Elder Baldur => Blocker
Mosscreep => MossWalker
Mossfly => MossFlyer
Mosskin => MossmanRunner
Volatile Mosskin => MossmanShaker
Fool Eater => SnapperTrap
Squit => Mosquito
Obble => BlobFlyer
Gulka => PlantShooter
Maskfly => Pigeon
Moss Charger => MossCharger
Massive Moss Charger => MegaMossCharger
Moss Knight => MossKnight
Mossy Vagabond => MossKnightFat
Durandoo => AcidWalker
Duranda => AcidFlyer
Aluba => LazyFlyer
Charged Lumafly => ZapBug
Uoma => JellyCrawler
Ooma => Jellyfish
Uumuu => MegaJellyfish
Ambloom => FungCrawler
Fungling => FungoonBaby
Fungoon => FungusFlyer
Sporg => MushroomTurret
Fungified Husk => FungifiedZombie
Shrumeling => MushroomBaby
Shrumal Warrior => MushroomRoller
Shrumal Ogre => MushroomBrawler
Mantis Youth => MantisFlyerChild
Mantis Warrior => Mantis
Mantis Lords => MantisLord
Husk Sentry => Sentry
Heavy Sentry => SentryFat
Winged Sentry => FlyingSentrySword
Lance Sentry => FlyingSentryJavelin
Mistake => MageBlob
Folly => MageBalloon
Soul Twister => Mage
Soul Warrior => MageKnight
Soul Master => MageLord
Husk Dandy => RoyalDandy
Cowardly Husk => RoyalCoward
Gluttonous Husk => RoyalPlumper
Gorgeous Husk => GorgeousHusk
Great Husk Sentry => GreatShieldZombie
Watcher Knight => BlackKnight
The Collector => JarCollector
Belfly => CeilingDropper
Pilflip => FlipHopper
Hwurmp => Inflater
Bluggsac => EggSac
Dung Defender => DungDefender
White Defender => WhiteDefender
Flukefey => Flukefly
Flukemon => Flukeman
Flukemunga => FatFluke
Flukemarm => FlukeMother
Shardmite => MinesCrawler
Glimback => CrystalCrawler
Crystal Hunter => CrystalFlyer
Crystal Crawler => LaserBug
Husk Miner => ZombieMiner
Crystallised Husk => BeamMiner
Crystal Guardian => MegaBeamMiner
Furious Vengefly => AngryBuzzer
Volatile Gruzzer => BurstingBouncer
Violent Husk => BurstingZombie
Slobbering Husk => SpittingZombie
Dirtcarver => BabyCentipede
Carver Hatcher => CentipedeHatcher
Garpede => BigCentipede
Corpse Creeper => SpiderCorpse
Deepling => MiniSpider
Deephunter => ShootSpider
Little Weaver => SpiderFlyer
Stalking Devout => SlashSpider
Nosk => MimicSpider
Shadow Creeper => AbyssCrawler
Lesser Mawlek => LesserMawlek
Mawlurk => MawlekTurret
Brooding Mawlek => Mawlek
Lightseed => OrangeScuttler
Infected Balloon => OrangeBalloon
Broken Vessel => InfectedKnight
Boofly => BlowFly
Primal Aspid => SuperSpitter
Hopper => Hopper
Great Hopper => GiantHopper
Grub Mimic => GrubMimic
Hiveling => BeeHatchling
Hive Soldier => BeeStinger
Hive Guardian => BigBee
Husk Hive => ZombieHive
Hive Knight => HiveKnight
Spiny Husk => GardenZombie
Loodle => GrassHopper
Mantis Petra => MantisHeavyFlyer
Mantis Traitor => HeavyMantis
Traitor Lord => TraitorLord
Sharp Baldur => ColRoller
Armoured Squit => ColMosquito
Battle Obble => Blobble
Oblobble => Oblobble
Shielded Fool => ColShield
Sturdy Fool => ColMiner
Winged Fool => ColFlyingSentry
Heavy Fool => ColWorm
Death Loodle => ColHopper
Volt Twister => ElectricMage
God Tamer => LobsterLancer
Pale Lurker => PaleLurker
Zote => Zote
Grey Prince Zote => GreyPrince
Winged Zoteling => ZotelingBuzzer
Hopping Zoteling => ZotelingHopper
Volatile Zoteling => ZotelingBalloon
Xero => GhostXero
Gorb => GhostAladar
Elder Hu => GhostHu
Marmu => GhostMarmu
No Eyes => GhostNoEyes
Galien => GhostGalien
Markoth => GhostMarkoth
Grimmkin Novice => FlameBearerSmall
Grimmkin Master => FlameBearerMed
Grimmkin Nightmare => FlameBearerLarge
Grimm => Grimm
Nightmare King => NightmareGrimm
Nailmasters Oro & Mato => NailBros
Paintmaster Sheo => Paintmaster
Great Nailsage Sly => Nailsage
Wingmould => PalaceFly
Royal Retainer => WhiteRoyal
Kingsmould => RoyalGuard
Sibling => Sibling
Void Tendrils => AbyssTendril
Hornet => Hornet
Hollow Knight => HollowKnight
Pure Vessel => HollowKnightPrime
Radiance => FinalBoss
Shade => Crawler
Hunter's Mark => HunterMark
Seal of Binding => BindingSeal
Void Idol => VoidIdol_1
Void Idol => VoidIdol_2
Void Idol => VoidIdol_3
Weathered Mask => GodseekerMask